WE ../texture/WE.xpm
EA ../texture/EA.xpm
NO ../texture/NO.xpm
SO ../texture/SO.xpm



F 115,115,115
C 0,119,179



1111111111111111111
1000000000000000001
1011001100011111001
1011001100000001101
1011001100000001101
101111110S011111001
1001111100011000001
1000001100011000001
1000001100011111101
1000000000000000001
1111111111111111111